000000000000000000000000000000000000000
011111111111111111111111111111111111100
010000000000000000000000000000000000100
010000000000000000110000000000000000100
010000000000000000110000000000000000100
010000000000000000110000000000000000100
010000000000000000110000000000000000100
010000000000000000110000000000000000100
010000000000000000110000000000000000100
010000000000000000110000000000000000100
010000000000000000110000000000000000100
010000000000000000110000000000000000100
010000000000000000110000000000000000100
010000000000000000110000000000000000100
010000000000000000110000000000000000100
010000000000000000110000000000000000100
010000000000000000110000000000000000100
010000000000000000110000000000000000100
010000000000000000110000000000000000100
010000000000000000110000000000000000100
010000000000000000110000000000000000100
010000000000000000000000000000000000100
